11111111111
10000000001
100000000P1
10000011111
10C00000001
11011111111
10000000001
10001111101
100010C0101
100E0000101
11111111111
